13 89 56 73 90 27 64 81 48 85
32 79 96 53 70 87 24 61 98 45
82 59 76 93 40 77 54 91 38 75
12 69 86 23 60 97 44 81 58 95
32 79 6 53 70 7 24 61 8 45
2 59 76 3 40 77 4 91 38 5
52 9 86 23 0 97 44 1 58 95
72 79 16 53 90 17 64 61 18 85
22 59 96 43 80 57 94 31 68 15
92 49 86 23 60 97 44 81 58 95
32 79 56 53 90 27 64 61 98 85
42 59 76 93 40 77 54 91 38 75
52 89 26 63 100 47 84 21 78 55
92 39 76 53 90 37 74 61 98 45
82 59 96 33 70 87 24 61 58 95
32 79 56 53 90 27 64 1 98 85
42 9 76 93 40 7 54 91 8 75
52 89 6 63 0 47 4 21 78 5
92 39 6 53 90 7 74 1 98 45
2 59 6 33 0 87 4 61 8 95
3 0 7 4 1 8 5 2 9 6
31 78 45 92 39 76 53 90 27 64
81 48 85 32 79 56 93 40 77 54
91 38 75 52 89 26 63 100 47 84
21 68 95 42 79 56 93 30 67 94
