47 83 12 96 31 74 8 52 19 65
88 23 67 41 94 6 58 29 76 13
91 37 80 15 62 99 44 7 53 26
78 35 89 18 71 46 2 84 57 22
95 68 11 49 86 33 77 24 61 98
42 75 9 56 87 20 63 100 38 82
17 69 45 92 28 74 51 5 85 39
66 21 79 48 93 16 72 59 34 88
25 81 54 97 43 76 12 68 90 27
64 50 3 86 41 79 36 73 18 95
52 89 26 67 84 31 78 15 61 94
29 75 48 91 37 83 60 7 44 87
22 69 96 53 80 46 93 28 65 100
38 74 11 58 85 32 79 56 23 70
47 84 19 66 92 35 78 51 88 24
73 49 86 33 77 54 91 27 64 98
40 76 13 59 95 42 81 28 67 89
36 72 55 90 26 63 99 45 82 37
68 21 75 48 85 60 94 31 77 50
43 86 29 74 97 52 88 25 71 96
12 67 84 41 98 55 72 29 86 43
80 37 94 51 68 25 82 59 96 33
70 87 24 61 78 45 92 39 76 53
90 27 64 81 48 85 32 79 56 93
40 77 54 91 38 75 52 89 26 63
