62 87 14 71 98 45 82 29 76 53
90 37 84 61 95 48 73 16 69 92
25 78 51 86 43 80 57 94 31 68
85 22 79 56 93 40 77 54 91 38
75 52 89 26 63 100 47 84 21 78
95 42 79 56 93 30 67 94 51 88
24 71 98 45 82 59 96 33 70 87
44 81 58 95 32 69 86 23 60 97
74 41 78 55 92 29 66 83 50 87
34 71 98 45 82 19 76 53 90 27
64 91 38 75 52 89 26 63 100 47
84 31 68 95 42 79 56 93 30 67
74 51 88 25 62 99 46 83 20 77
94 41 78 55 92 39 76 53 90 37
84 61 98 45 82 29 66 93 50 87
34 71 88 25 62 99 46 83 20 77
54 91 38 75 52 89 26 63 100 47
84 31 68 95 42 79 16 93 50 87
34 71 8 45 82 59 96 33 70 17
44 81 18 95 32 69 6 23 60 7
85 42 79 56 93 30 67 94 51 88
24 71 98 45 82 19 76 53 90 27
64 91 38 75 12 89 46 63 100 17
34 81 58 95 32 69 86 23 60 97
74 41 78 15 92 49 66 83 20 77
