83 40 97 54 71 88 35 72 89 46
63 80 37 74 91 48 85 42 79 56
93 50 87 34 71 98 45 82 39 76
53 90 47 84 61 98 35 72 89 26
63 100 37 74 11 48 85 22 79 56
13 50 87 14 71 18 45 2 39 76
53 10 47 4 61 18 35 12 89 26
63 20 37 14 11 48 5 22 79 6
13 0 87 14 1 18 45 2 39 6
53 10 7 4 61 8 35 12 9 26
3 20 7 14 11 8 5 22 9 6
13 0 17 14 1 18 5 2 9 6
53 10 7 44 61 48 75 52 89 66
83 40 77 94 51 88 65 72 89 46
83 100 97 54 71 8 35 72 9 46
63 0 37 74 1 48 5 42 9 56
3 0 7 34 1 8 45 2 39 6
53 0 7 4 61 8 35 2 9 26
27 64 18 92 55 31 77 43 86 12
99 7 68 23 81 49 60 35 14 70
58 21 95 3 88 40 76 29 53 62
11 84 36 97 25 50 72 19 90 6
44 79 13 57 100 8 32 67 24 85
63 100 37 74 91 48 85 42 79 56
41 78 15 92 49 66 83 20 77 54
91 38 75 52 89 26 63 100 47 84
21 68 95 42 79 56 93 30 67 94
51 88 25 62 99 46 83 20 77 54
91 38 75 12 89 46 63 0 47 4
61 18 35 12 89 26 63 20 37 14
